4 4 4 4 4 4 4 4 4 4 4 4 4 4 4 4 4 4 4 4 4 4 4 4 4 4 4 4 4 4 4 4 4 4 4 4 4 4 4 4 4 4 4 4 4 4 4 4 4 4 
4 4 4 4 4 4 4 4 4 4 4 4 4 4 4 4 4 4 4 4 4 4 4 4 4 4 4 4 4 4 4 4 4 4 4 4 4 4 4 4 4 4 4 4 4 4 4 4 4 4 
4 4 4 4 4 4 4 4 4 4 4 4 4 4 4 4 4 4 4 4 4 0 0 0 0 0 0 0 0 0 0 4 4 4 4 0 0 0 0 0 0 0 0 0 0 0 0 4 4 4 
4 4 1 1 1 1 1 1 1 1 1 1 1 1 1 1 1 4 4 0 0 0 0 0 0 0 0 0 0 0 0 0 0 0 0 0 0 0 0 0 0 0 0 0 0 0 0 4 4 4 
4 4 1 5 5 5 5 5 1 5 5 5 5 5 5 5 1 4 0 0 0 0 0 0 0 0 0 0 0 0 0 0 0 0 0 0 0 0 0 0 4 4 4 4 4 4 4 4 4 4 
4 4 1 5 5 5 5 5 5 5 5 5 5 5 5 5 1 4 4 0 0 0 0 0 0 0 0 0 0 4 4 4 4 4 4 4 4 4 4 4 4 4 4 4 4 4 4 4 4 4
4 4 1 5 5 5 5 5 1 5 5 5 5 5 5 5 1 4 4 0 0 0 0 0 0 0 4 4 4 4 4 4 4 4 4 4 4 4 4 4 4 4 4 4 4 4 4 4 4 4 
4 4 1 5 5 5 5 5 1 5 5 5 5 5 5 5 1 4 4 4 0 0 0 0 0 4 4 4 4 4 0 0 0 0 0 0 0 0 0 0 0 0 0 4 4 4 4 4 4 4 
4 4 1 5 5 5 5 5 1 1 1 1 1 5 5 1 1 4 4 4 0 0 0 0 0 4 4 4 0 0 0 0 0 0 0 0 0 0 0 0 0 0 0 0 0 0 4 4 4 4 
4 4 1 5 5 5 5 5 1 5 5 5 5 5 5 5 1 4 4 4 0 0 0 0 4 4 4 0 0 0 0 0 3 3 3 3 3 3 0 0 0 0 0 0 0 0 4 4 4 4 
4 4 1 5 5 5 5 5 1 5 5 5 5 5 5 5 1 4 4 0 0 0 0 4 4 4 0 0 0 0 0 3 3 2 2 2 2 3 3 3 0 0 0 0 0 0 0 4 4 4
4 4 1 1 5 1 1 1 1 5 5 5 5 5 5 5 1 4 0 0 0 0 0 4 4 0 0 0 0 0 3 3 2 2 2 2 2 2 2 3 3 3 3 0 0 0 0 0 4 4
4 4 1 5 5 5 5 5 5 5 5 5 5 5 5 5 1 4 0 0 0 0 4 4 4 0 0 0 0 3 3 2 2 2 2 2 2 2 2 2 2 2 3 3 3 0 0 0 4 4 
4 4 1 5 5 5 5 5 1 5 5 5 5 5 5 5 1 4 0 0 0 0 4 4 0 0 0 0 0 3 2 2 2 2 2 2 2 2 2 2 2 2 2 2 3 0 0 0 4 4 
4 4 1 5 5 5 5 5 1 5 5 5 5 5 5 5 1 4 0 0 0 0 4 4 0 0 0 0 3 3 2 2 2 2 2 2 2 2 2 2 2 2 2 2 3 0 0 0 4 4 
4 4 1 1 1 1 1 1 1 1 1 1 1 5 5 1 1 4 0 0 0 0 4 4 0 0 0 0 3 2 2 2 2 2 2 2 2 2 2 2 2 2 2 2 3 0 0 0 4 4
4 5 5 5 5 5 5 0 0 0 0 0 5 5 5 5 4 4 4 0 0 0 0 4 4 0 0 0 3 2 2 2 2 2 2 2 2 2 2 2 2 2 2 3 3 0 0 0 4 4
4 2 5 2 5 2 5 0 0 0 0 0 0 5 5 0 4 4 4 0 0 0 0 0 4 0 0 0 3 2 2 2 2 2 2 2 2 2 2 2 2 2 2 3 0 0 0 4 4 4
4 2 5 2 5 2 5 0 0 0 0 0 0 0 0 0 0 4 4 0 0 0 0 0 4 0 0 0 3 2 2 2 2 2 2 2 2 2 2 2 2 2 2 3 0 0 0 4 4 4
4 2 5 2 5 2 5 0 0 4 4 0 0 0 0 0 0 4 4 4 0 0 0 0 4 4 0 0 3 3 2 2 2 2 2 2 2 2 2 2 2 2 2 3 0 0 0 4 4 4
4 2 5 2 5 2 5 0 4 4 4 4 0 0 0 0 0 0 4 4 4 0 0 0 0 4 0 0 0 3 3 2 2 2 2 2 2 2 2 2 2 2 3 3 0 0 0 0 4 4
4 2 5 2 5 2 5 0 0 4 4 0 0 0 0 0 0 0 4 4 4 4 0 0 0 4 4 0 0 0 3 3 2 2 2 2 2 2 2 2 2 3 3 0 0 0 0 4 4 4
4 2 5 2 5 2 5 0 0 0 0 0 0 4 4 0 0 0 0 0 0 4 4 0 0 0 4 0 0 0 0 3 3 2 2 2 2 2 2 3 3 3 0 0 0 0 4 4 4 4
4 5 5 5 5 5 5 0 0 0 0 0 4 4 4 4 0 0 0 0 0 0 0 0 0 0 0 0 0 0 0 0 3 3 3 3 3 3 3 3 0 0 0 0 0 0 4 4 4 4
4 4 4 4 4 4 4 4 4 4 4 4 4 4 4 4 4 4 4 4 4 4 0 0 0 4 4 4 4 4 4 0 0 0 0 0 0 0 0 0 0 0 0 0 0 0 4 4 4 4
4 4 4 4 4 4 4 4 4 4 4 4 4 4 4 4 4 4 4 4 4 4 4 0 0 4 4 4 4 4 4 4 0 0 0 0 0 0 0 0 0 0 0 0 0 4 4 4 4 4
4 4 4 4 4 4 4 4 4 4 4 4 4 4 4 4 4 4 4 4 4 0 0 0 0 0 0 0 0 4 4 4 4 4 4 4 4 4 0 0 0 0 0 4 4 4 4 4 4 4 
4 4 4 4 4 4 4 4 4 4 4 4 4 4 4 4 4 4 4 4 4 0 0 0 0 0 0 0 0 0 0 4 4 4 4 4 4 4 4 4 4 4 4 4 4 4 4 4 4 4 
4 0 4 4 4 4 4 4 4 4 4 4 4 4 4 4 4 4 4 4 0 0 0 0 4 4 0 0 0 0 0 0 0 0 0 0 0 4 4 4 4 4 4 4 4 4 4 4 4 4
4 0 0 4 4 4 4 4 4 4 4 4 4 4 4 4 4 4 0 0 0 0 0 4 4 4 4 0 0 0 0 0 0 0 0 0 4 4 4 4 4 4 4 4 4 4 4 4 4 4
4 0 0 0 0 0 0 0 0 4 4 4 4 4 0 0 0 0 0 0 0 0 4 4 4 4 4 4 0 0 0 0 0 0 0 0 0 0 0 0 0 4 4 4 4 0 0 0 0 4
4 0 0 0 0 0 0 0 0 0 0 0 0 0 0 0 0 0 0 0 0 4 4 4 4 4 4 4 0 0 0 0 0 0 0 0 0 0 0 4 4 4 4 4 0 0 0 0 0 4
4 0 0 0 0 0 0 0 0 0 0 0 0 0 0 0 0 0 0 0 0 4 4 4 4 4 4 4 0 0 0 0 0 0 0 0 0 4 4 4 4 4 4 0 0 0 0 0 0 4
4 0 0 0 0 0 4 4 4 4 4 4 0 0 0 0 0 0 0 0 4 4 4 4 4 4 4 4 0 0 0 0 0 0 0 4 4 4 4 4 4 4 0 0 0 0 0 0 0 4
4 0 0 0 4 4 4 4 4 4 4 4 4 4 0 0 0 0 0 4 4 4 4 4 4 4 4 0 0 0 0 0 4 4 4 4 4 4 4 4 0 0 0 0 0 0 0 0 0 4
4 0 0 4 4 4 4 4 4 4 4 4 4 4 4 0 0 0 0 4 4 4 4 4 4 4 0 0 0 0 0 4 4 4 4 4 4 4 4 0 0 0 0 0 0 0 0 0 0 4
4 0 0 4 4 4 4 4 4 4 4 4 4 4 4 0 0 0 4 4 4 4 4 4 0 0 0 0 0 0 4 4 4 4 4 4 4 0 0 0 0 0 0 0 0 0 0 0 0 4
4 0 4 4 4 4 4 4 4 4 4 4 4 0 0 0 0 0 4 4 4 4 0 0 0 0 0 0 0 4 4 4 4 4 4 0 0 0 0 0 0 0 0 0 0 0 0 0 0 4
4 0 4 4 4 4 4 4 4 4 4 4 0 0 0 0 0 0 0 4 4 0 0 0 0 0 0 0 4 4 4 4 4 4 0 0 0 0 0 0 0 0 0 0 0 0 0 0 0 4
4 0 4 4 4 4 4 4 4 0 0 0 0 0 0 0 0 0 0 4 0 0 0 0 0 0 0 0 0 4 4 4 4 4 4 4 4 4 4 4 4 4 4 4 4 0 0 0 0 4
4 0 0 0 4 4 4 0 0 0 0 0 0 0 0 0 0 0 0 0 0 0 0 0 0 0 0 0 0 0 0 0 0 0 4 0 0 4 0 4 0 0 0 0 4 0 0 0 0 4
4 0 0 0 0 0 0 0 0 0 0 0 0 0 0 0 0 0 0 0 0 0 0 0 0 0 0 0 0 4 4 4 4 0 4 0 4 0 0 0 0 4 4 0 4 0 0 0 0 4
4 0 0 0 0 0 0 0 0 0 0 4 4 4 4 4 0 0 0 0 0 0 0 0 0 0 0 0 0 4 0 0 4 0 4 0 4 4 4 4 0 4 0 0 4 0 0 0 0 4
4 0 0 0 0 0 0 4 4 4 4 4 4 4 4 4 4 4 4 4 0 0 0 0 0 0 0 0 0 4 0 4 4 0 0 0 0 0 0 4 0 4 0 4 4 0 0 0 0 4
4 0 0 0 0 0 4 4 4 4 4 4 4 4 4 4 4 4 4 4 4 0 0 0 0 0 0 0 0 4 0 0 0 0 4 4 0 4 0 0 0 4 0 0 4 0 0 0 0 4
4 0 0 0 0 4 4 4 4 4 4 4 4 4 4 4 4 4 4 4 4 0 0 0 0 0 0 0 0 4 4 4 4 0 4 0 0 4 4 4 0 4 4 0 4 0 0 0 0 4
4 0 0 0 0 0 4 4 4 4 4 4 4 4 4 4 4 4 4 4 0 0 0 0 0 0 0 0 0 4 0 0 4 0 4 0 4 4 0 0 0 0 4 0 4 0 0 0 0 4
4 0 0 0 0 0 0 4 4 4 4 4 4 4 4 4 4 4 0 0 0 0 0 0 0 0 0 0 0 4 0 4 4 0 4 0 0 4 0 4 4 0 4 0 4 0 0 0 0 4
4 0 0 0 0 0 0 0 0 0 0 0 0 0 0 0 0 0 0 0 0 0 0 0 0 0 0 0 0 4 0 4 0 0 4 0 4 4 0 4 0 0 4 0 0 0 0 0 0 4
4 4 4 4 4 4 4 4 4 4 4 4 4 4 4 4 4 4 4 4 4 4 4 4 4 4 4 4 4 4 4 4 4 4 4 4 4 4 4 4 4 4 4 4 4 4 4 4 4 4