0 1 2 3 4 5 6 7 8 9 10 11 12 13 14 15 16 0 0 0 0 0 0 0 0 0 0 0 0 0 0 0 0 0 0 0 0 0 0 0 0 0 0 0 0 0 0 0 0 0 0 0 0 0 0 0 0 0 0 0 0 0 0 0 0 0 0 0 0 0 0 0 0 0 0 0 0 0 0 0 0 0 0 0 0 0 0 0 0 0 0 0 0 0 0 0 0 0 0 0
0 0 0 0 0 0 0 0 0 0 0 0 0 0 0 0 0 0 0 0 0 0 0 0 0 0 0 0 0 0 0 0 0 0 0 0 0 0 0 0 0 0 0 0 0 0 0 0 0 0 0 0 0 0 0 0 0 0 0 0 0 0 0 0 0 0 0 0 0 0 0 0 0 0 0 0 0 0 0 0 0 0 0 0 0 0 0 0 0 0 0 0 0 0 0 0 0 0 0 0
0 0 0 0 0 0 0 0 0 0 0 0 0 0 0 0 0 0 0 0 0 0 0 0 0 0 0 0 0 0 0 0 0 0 0 0 0 0 0 0 0 0 0 0 0 0 0 0 0 0 0 0 0 0 0 0 0 0 0 0 0 0 0 0 0 0 0 0 0 0 0 0 0 0 0 0 0 0 0 0 0 0 0 0 0 0 0 0 0 0 0 0 0 0 0 0 0 0 0 0
0 0 0 0 0 0 0 0 0 0 0 0 0 0 0 0 0 0 0 0 0 0 0 0 0 0 0 0 0 0 0 0 0 0 0 0 0 0 0 0 0 0 0 0 0 0 0 0 0 0 0 0 0 0 0 0 0 0 0 0 0 0 0 0 0 0 0 0 0 0 0 0 0 0 0 0 0 0 0 0 0 0 0 0 0 0 0 0 0 0 0 0 0 0 0 0 0 0 0 0
0 0 0 0 0 0 0 0 0 0 0 0 0 0 0 0 0 0 0 0 0 0 0 0 0 0 0 0 0 0 0 0 0 0 0 0 0 0 0 0 0 0 0 0 0 0 0 0 0 0 0 0 0 0 0 0 0 0 0 0 0 0 0 0 0 0 0 0 0 0 0 0 0 0 0 0 0 0 0 0 0 0 0 0 0 0 0 0 0 0 0 0 0 0 0 0 0 0 0 0
0 0 0 0 0 0 0 0 0 0 0 0 0 0 0 0 0 0 0 0 0 0 0 0 0 0 0 0 0 0 0 0 0 0 4 4 4 4 0 4 4 4 4 4 0 4 4 0 0 0 0 0 0 0 0 0 0 0 0 0 0 0 0 0 0 0 0 0 0 0 0 0 0 0 0 0 0 0 0 0 0 0 0 0 0 0 0 0 0 0 0 0 0 0 0 0 0 0 0 0
0 0 0 0 0 0 0 0 0 0 0 0 0 0 0 0 0 0 0 0 0 0 0 0 0 0 0 0 0 0 0 0 4 4 4 0 4 4 4 4 0 4 0 0 0 0 0 0 0 0 0 0 0 0 0 0 0 0 0 0 0 0 0 0 0 0 0 0 0 0 0 0 0 0 0 0 0 0 0 0 0 0 0 0 0 0 0 0 0 0 0 0 0 0 0 0 0 0 0 0
0 0 0 0 0 0 0 0 0 0 0 0 0 0 0 0 0 0 0 0 0 0 0 0 0 0 0 0 4 4 4 4 4 4 4 4 0 4 0 0 0 4 0 0 0 4 4 4 4 0 4 4 4 4 0 0 0 0 4 0 0 0 0 0 0 0 0 0 0 0 0 0 0 0 0 0 0 0 0 0 0 0 0 0 0 0 0 0 0 0 0 0 0 0 0 0 0 0 0 0
0 0 0 0 0 0 0 0 0 0 0 0 0 0 0 0 0 0 0 0 0 0 0 0 0 0 4 4 4 4 4 14 0 4 4 4 0 0 4 0 4 0 4 4 4 4 4 4 0 0 4 4 4 4 0 0 0 0 0 0 4 0 0 0 4 0 0 0 0 0 4 0 0 0 0 0 0 0 0 0 0 0 0 0 0 0 0 0 0 0 0 0 0 0 0 0 0 0 0 0
0 0 0 0 0 0 0 0 0 0 0 0 0 0 0 0 0 0 0 0 0 0 4 4 4 4 4 4 0 4 4 4 0 0 0 0 0 0 0 0 4 0 4 4 4 0 0 0 4 0 0 0 4 0 4 0 4 0 0 4 4 4 4 0 0 0 0 0 0 0 0 0 0 4 0 0 0 4 4 0 0 0 0 4 14 4 4 4 4 4 4 4 4 4 0 0 0 0 0 0
0 0 0 0 0 0 0 4 4 4 4 0 0 0 0 0 0 4 4 0 4 4 4 4 4 0 0 0 0 4 0 0 4 4 4 0 0 0 0 0 4 4 4 4 0 4 4 4 0 0 0 0 0 4 0 0 0 4 0 0 0 0 0 0 0 0 0 0 4 0 0 4 0 0 0 4 4 4 4 4 0 4 14 4 0 0 0 0 0 0 0 4 4 0 0 0 0 0 0 0
0 0 0 0 0 0 4 4 0 0 0 0 0 0 0 0 14 14 14 14 0 4 4 4 0 0 0 0 0 0 4 4 0 4 0 0 0 0 0 0 0 0 0 0 0 0 0 0 0 0 0 0 0 0 0 0 14 0 0 4 4 4 4 4 4 0 4 0 0 0 0 0 0 0 0 0 0 4 0 0 0 4 4 0 0 4 4 4 0 4 4 4 0 0 0 0 0 0 0 0
0 0 0 0 0 4 0 0 0 0 0 0 0 14 14 0 0 0 0 0 4 4 4 14 14 0 0 4 4 0 0 0 4 4 0 0 0 0 0 0 0 0 0 0 0 0 0 0 0 0 0 0 0 0 0 0 4 4 4 4 0 0 0 0 0 0 0 0 0 0 0 0 0 0 0 0 0 4 4 0 4 4 4 0 4 4 4 4 4 4 4 0 0 0 0 0 0 0 0 0
0 0 0 0 0 4 0 0 0 0 0 0 0 14 0 0 0 0 0 4 4 0 4 0 4 4 0 4 0 0 0 4 0 0 0 6 6 6 6 6 6 6 6 6 6 6 6 6 6 6 0 0 0 0 0 4 0 0 0 0 0 0 0 4 0 4 0 4 0 4 4 4 4 0 0 0 0 0 0 4 4 4 4 4 4 4 4 0 4 4 0 0 0 0 0 0 0 0 0 0
0 0 0 0 0 4 0 0 0 0 0 0 0 0 0 0 4 4 4 0 0 0 4 4 0 0 4 0 0 0 0 4 0 0 0 6 6 6 10 10 10 6 9 9 9 6 7 7 7 6 6 6 6 6 0 4 4 4 4 4 4 0 0 4 0 4 0 4 0 14 4 0 0 0 0 0 0 0 0 4 0 4 0 0 4 4 0 4 0 0 0 0 0 0 0 0 0 0 0 0
0 14 0 0 0 4 0 0 0 0 0 0 4 4 4 4 0 0 0 14 0 0 0 0 4 4 4 4 0 4 4 4 0 6 6 6 6 6 10 10 10 6 9 9 9 6 7 7 7 6 6 6 6 6 4 4 4 0 0 0 0 0 0 0 0 0 4 4 4 0 4 4 4 4 4 4 4 4 0 4 4 0 0 4 0 4 0 0 0 0 4 0 0 4 0 0 4 4 4 4
0 0 0 0 0 0 0 0 0 0 4 4 0 4 4 0 0 0 0 0 0 0 0 4 0 4 0 0 4 4 4 0 0 0 6 6 6 6 6 10 6 6 6 9 6 6 6 7 6 6 6 6 6 6 0 0 0 0 0 0 0 0 0 0 0 0 4 0 0 4 4 4 4 4 0 4 4 4 4 4 4 4 4 4 4 4 0 4 4 4 4 4 4 4 4 4 0 0 4 0
0 0 0 0 0 4 0 0 0 4 4 4 4 4 4 0 4 0 4 4 0 0 0 0 4 0 0 4 0 4 0 0 0 6 6 6 6 6 6 6 6 6 6 6 6 6 6 6 6 6 6 6 6 6 4 4 4 0 4 4 0 4 4 0 4 4 4 4 4 4 4 4 4 0 0 4 0 4 4 4 4 4 4 0 4 0 4 4 4 4 4 4 4 4 0 0 0 0 0 0
0 0 0 0 4 4 4 4 4 0 0 4 4 4 4 4 4 0 0 0 0 0 0 4 0 0 0 0 0 4 0 0 0 6 6 7 6 6 6 9 6 6 6 8 6 6 6 10 6 6 6 7 6 6 0 0 0 4 0 0 0 0 0 0 0 0 0 0 4 0 4 4 0 0 0 0 0 0 0 0 0 4 4 4 4 4 4 4 4 4 4 0 0 0 0 0 0 0 0 0
0 0 4 4 0 4 4 4 4 4 4 4 4 0 0 0 0 0 0 0 0 0 4 4 0 4 0 0 0 0 0 0 0 6 7 7 7 6 9 9 9 6 8 8 8 6 10 10 10 6 7 7 7 6 0 0 0 0 0 0 0 4 0 0 4 0 0 4 0 0 0 0 0 4 0 4 4 4 4 0 4 0 0 0 0 0 0 0 0 0 0 0 0 0 0 0 0 0 0 0
0 4 0 4 4 0 4 4 4 4 4 4 4 0 0 0 0 0 0 0 0 4 4 0 0 0 0 0 0 0 0 0 0 6 7 7 7 6 9 9 9 6 8 8 8 6 10 10 10 6 7 7 7 6 0 0 0 0 0 0 0 0 0 0 0 0 0 0 0 0 0 0 0 0 0 0 0 0 0 0 0 0 0 0 0 0 0 0 0 0 14 0 0 0 0 14 14 14 4 0
0 0 0 4 0 4 4 4 4 4 4 4 4 0 1 1 1 1 1 1 1 1 1 1 1 6 6 6 6 6 6 6 6 6 6 6 6 6 6 6 6 6 6 6 6 6 6 6 6 6 6 6 6 6 6 6 6 6 6 6 6 6 6 6 6 6 6 6 6 6 6 6 6 6 6 6 6 6 6 6 6 6 6 6 6 6 6 6 0 0 0 14 4 0 0 14 0 14 0 0
14 0 0 4 4 0 4 4 4 4 4 4 0 0 1 1 1 1 1 1 1 1 1 1 1 6 6 6 6 6 6 6 6 6 6 6 6 6 6 6 6 6 12 12 12 6 6 6 6 6 9 9 9 6 8 6 6 6 7 6 6 7 6 10 10 6 6 6 7 7 6 6 8 6 8 6 9 6 9 6 8 8 8 6 7 6 6 6 0 0 0 0 0 0 0 0 0 14 0 0
4 4 4 4 4 0 4 4 4 4 4 4 0 0 1 9 1 9 1 9 1 9 1 9 1 6 17 17 17 17 17 17 17 17 17 17 17 17 6 12 12 12 12 12 12 12 12 12 6 9 6 6 6 6 8 6 6 6 7 6 6 7 6 10 6 10 6 6 7 6 7 6 8 6 8 6 9 6 9 6 8 6 6 6 7 6 6 6 0 14 14 0 0 4 0 0 14 0 0 0
0 0 0 4 4 4 4 4 4 4 0 0 0 0 1 9 1 9 1 9 1 9 1 9 1 6 6 10 6 6 6 7 6 6 6 8 6 6 6 12 12 12 12 12 12 12 12 12 6 9 6 6 6 6 8 6 6 6 7 6 6 7 6 10 10 6 6 6 7 7 6 6 8 8 8 6 6 9 6 6 8 8 8 6 7 6 6 6 0 0 14 0 0 0 14 0 0 0 0 0
0 14 0 4 4 4 4 0 4 0 14 0 0 0 1 9 1 9 1 9 1 9 1 9 1 6 10 10 10 6 7 7 7 6 8 8 8 6 6 12 12 12 12 12 12 12 12 12 6 9 6 6 6 6 8 6 6 6 7 6 6 7 6 10 6 10 6 6 7 6 6 6 6 8 6 6 9 6 9 6 8 6 6 6 7 6 6 6 0 0 14 0 0 4 0 14 0 0 14 0
0 0 0 0 0 4 0 0 0 0 0 0 0 0 1 9 1 9 1 9 1 9 1 9 1 6 10 10 10 6 7 7 7 6 8 8 8 6 6 12 12 12 12 12 12 12 12 12 6 6 9 9 9 6 8 8 8 6 6 7 7 6 6 10 10 6 6 6 7 6 6 6 6 8 6 6 9 6 9 6 8 8 8 6 7 7 7 6 0 0 0 0 0 0 0 0 0 0 0 0
11 11 11 11 4 11 11 11 11 11 11 11 11 11 1 1 1 1 1 1 1 1 1 1 1 6 17 17 17 17 17 17 17 17 17 17 17 17 6 12 12 12 12 12 12 12 12 12 6 17 17 17 17 17 17 17 17 17 17 17 17 17 17 17 17 17 17 17 17 17 17 17 17 17 17 17 17 17 17 17 17 17 17 17 17 17 17 6 11 11 11 11 11 11 11 11 11 11 11 11
0 4 4 0 0 0 0 0 0 0 1 12 12 12 12 12 12 12 12 12 12 12 12 12 12 12 12 12 12 12 12 12 12 12 12 12 12 12 12 12 12 12 12 12 12 12 12 12 12 12 12 12 12 12 12 12 12 12 12 12 12 12 12 12 12 12 12 12 12 12 12 12 12 12 12 12 12 12 12 12 12 12 12 12 12 12 12 12 1 0 0 0 0 0 0 0 0 0 0 0
4 0 0 0 0 0 0 0 0 0 1 12 12 12 12 12 12 12 12 12 12 12 12 12 12 12 12 12 12 12 12 12 12 12 12 12 12 12 12 12 12 12 12 12 12 12 12 12 12 12 12 12 12 12 12 12 12 12 12 12 12 12 12 12 12 12 12 12 12 12 12 12 12 12 12 12 12 12 12 12 12 12 12 12 12 12 12 12 1 0 0 0 0 0 0 0 0 0 0 0 
0 0 0 0 0 4 4 0 0 0 1 12 12 12 12 12 12 12 12 12 12 12 12 12 12 12 12 12 12 12 12 12 12 12 12 12 12 12 12 12 12 12 12 12 12 12 12 12 12 12 12 12 12 12 12 12 12 12 12 12 12 12 12 12 12 12 12 12 12 12 12 12 12 12 12 12 12 12 12 12 12 12 12 12 12 12 12 12 1 0 0 0 0 0 0 0 0 0 0 0
14 0 0 0 4 4 4 0 0 0 11 0 0 0 0 0 0 0 0 0 0 0 0 0 0 0 0 0 0 0 4 0 0 0 0 0 0 0 0 0 0 0 0 5 0 0 5 0 0 5 0 0 0 0 0 0 0 0 0 0 0 0 0 0 0 0 12 12 12 0 0 0 0 0 0 0 0 0 0 0 0 0 0 0 0 0 0 0 11 0 0 0 0 0 0 0 0 0 0 0 
0 0 0 0 4 0 14 4 0 0 11 0 0 0 0 4 0 0 0 0 4 0 0 4 0 0 0 4 0 0 0 0 0 0 0 0 0 0 0 0 0 0 0 5 5 5 5 0 5 0 0 0 14 0 0 0 0 0 0 0 0 0 5 0 0 0 12 12 12 0 0 0 0 0 0 0 0 0 0 0 0 0 0 0 0 0 0 0 11 0 0 0 0 4 0 0 0 4 0 0
0 0 0 4 4 0 0 4 0 0 11 0 4 0 0 0 0 0 0 4 0 0 0 4 4 0 0 0 0 4 0 4 0 0 4 5 0 0 0 0 0 0 0 5 5 5 0 0 0 0 0 0 0 0 0 0 0 0 0 0 5 5 0 0 0 0 12 12 12 0 0 0 0 0 0 0 0 0 0 0 0 0 4 0 14 0 0 0 11 0 0 0 4 4 4 4 4 4 0 0
0 0 4 4 4 0 0 14 0 0 11 0 0 0 4 0 0 0 4 4 0 0 0 0 0 0 4 0 0 0 0 0 0 0 0 0 0 0 0 0 0 0 0 0 5 0 0 0 0 0 0 0 0 0 0 5 5 5 5 0 0 0 0 0 0 0 12 12 12 0 0 0 0 0 0 0 0 0 0 0 0 0 0 0 0 0 4 0 11 0 14 0 4 4 4 4 4 0 0 0
0 4 14 4 4 0 0 0 0 0 11 0 0 4 0 0 0 4 14 0 5 4 4 14 4 0 4 0 14 0 4 0 4 0 0 0 5 0 5 0 0 0 0 5 5 5 0 0 0 0 0 0 0 0 5 0 0 0 0 5 0 11 11 11 11 11 12 12 12 11 11 11 11 11 0 0 0 4 0 14 0 0 0 0 0 0 0 0 11 0 0 0 0 4 4 4 0 0 0 0
0 4 14 4 4 0 0 4 0 0 11 0 4 0 14 0 0 0 0 4 0 0 0 0 0 0 0 0 0 0 0 0 5 0 0 0 0 0 0 0 0 0 5 0 5 0 5 0 0 0 0 0 5 5 0 5 0 5 0 5 0 11 0 0 0 0 1 13 1 0 14 0 0 11 0 0 0 0 0 0 0 0 0 0 0 0 0 0 11 0 0 0 4 0 4 4 0 0 0 0
4 4 0 4 0 0 14 4 0 0 11 0 0 0 0 4 4 0 0 0 0 4 0 4 0 0 4 0 0 4 0 0 0 4 0 0 4 0 5 5 0 0 0 0 5 5 0 0 0 0 5 5 0 0 0 5 0 0 0 0 0 11 4 0 4 0 1 13 1 0 5 0 14 11 0 0 0 0 0 0 0 0 0 14 0 0 0 0 11 0 0 0 0 0 0 4 0 0 0 0 
4 0 0 4 0 0 4 0 0 0 11 0 0 4 0 0 0 0 4 0 0 0 14 0 0 0 0 5 0 0 0 4 0 0 0 4 14 4 0 0 0 0 0 5 0 5 0 0 5 5 0 0 5 0 5 0 0 0 0 0 0 11 0 0 0 0 1 13 1 14 0 4 0 11 0 0 0 0 0 0 0 0 0 0 0 0 0 0 11 0 0 4 4 0 0 0 0 4 4 4 
4 0 0 4 0 4 4 0 0 0 11 0 0 0 0 4 0 14 0 5 4 0 0 0 4 14 0 4 5 0 0 0 14 5 0 0 5 0 5 0 5 5 5 0 5 5 5 0 0 5 0 0 5 5 0 5 0 0 0 0 0 11 14 5 0 0 1 13 1 0 0 0 0 11 0 0 0 0 0 0 0 0 0 0 0 4 0 0 11 0 0 4 4 0 0 4 0 4 0 4 
4 0 4 0 4 4 4 0 0 0 11 0 0 0 4 0 4 0 0 4 0 5 0 0 0 0 0 0 0 4 4 0 0 4 4 4 0 0 5 5 5 0 5 5 5 5 0 5 0 0 0 5 0 0 0 0 0 0 0 0 0 11 0 0 4 0 1 13 1 0 0 5 0 11 0 0 0 0 4 0 0 0 0 0 0 0 0 0 11 0 0 4 14 0 0 0 4 0 0 0 
4 0 4 0 4 4 14 0 0 0 11 0 0 0 0 0 5 0 0 14 0 0 0 4 0 0 14 0 0 14 0 0 0 0 0 0 0 5 5 5 5 5 0 5 5 5 5 0 5 0 0 5 0 0 0 14 0 0 0 0 0 11 4 0 14 0 1 13 1 0 4 0 0 11 0 0 0 0 0 0 0 0 0 0 0 0 0 0 11 0 0 0 0 0 0 4 4 4 0 4
4 0 4 0 4 4 0 0 0 0 11 0 0 4 0 4 4 0 4 0 0 4 0 14 0 0 4 0 4 0 0 14 0 0 0 4 0 4 0 0 0 5 5 0 0 5 5 5 5 0 0 0 0 0 0 0 0 0 0 0 0 11 5 5 5 5 1 13 1 5 5 5 5 11 0 0 0 14 0 0 0 0 0 0 0 0 0 0 11 0 0 0 0 0 4 4 4 4 0 4 
4 4 4 4 4 4 4 0 0 0 11 0 0 0 0 0 0 0 0 0 0 5 0 0 4 0 5 5 0 0 0 4 4 0 0 0 4 0 5 0 5 0 0 5 0 5 5 0 0 0 5 5 0 4 0 0 0 0 0 0 0 11 5 1 1 1 1 13 1 1 1 1 5 11 0 0 0 0 0 0 0 0 0 0 0 0 0 0 11 0 0 0 0 0 0 4 0 4 0 0 
4 4 4 4 0 4 4 0 0 0 11 0 0 0 0 4 14 5 4 0 4 0 0 0 0 14 0 4 0 4 0 0 0 0 4 0 0 0 0 5 0 0 0 5 0 0 0 0 0 0 0 0 0 0 0 0 0 14 0 0 0 11 5 1 13 13 13 13 13 13 13 1 5 11 0 0 0 0 0 0 0 0 0 0 0 0 0 0 11 0 14 0 0 0 4 4 4 0 0 4 
4 4 4 4 0 4 0 0 0 0 11 0 0 0 0 0 0 0 0 0 0 4 14 0 4 0 0 5 0 5 0 4 0 0 0 0 4 0 5 0 0 0 0 0 5 5 5 0 5 0 0 0 0 0 0 0 0 0 0 0 0 11 5 1 13 13 13 13 13 13 13 1 5 11 0 0 0 0 0 0 0 4 0 0 4 0 4 0 11 0 0 0 0 0 4 4 4 4 0 0 
14 14 4 4 0 4 4 4 0 0 11 0 0 4 0 0 4 0 4 0 5 0 0 0 0 0 0 0 4 0 0 4 4 0 0 0 4 0 0 0 5 0 0 0 0 5 0 0 0 0 0 0 0 0 0 0 0 0 0 0 0 11 5 1 13 13 13 13 13 13 13 1 5 11 0 0 0 0 0 0 0 0 0 4 4 0 4 4 11 0 0 0 0 4 4 0 4 4 0 0 
14 0 4 4 4 4 4 4 0 0 11 0 0 0 0 0 0 5 0 4 0 14 0 4 0 4 0 0 0 0 0 0 0 0 4 0 0 5 0 0 0 5 0 5 5 5 5 0 0 0 14 0 0 0 0 0 0 0 0 0 0 11 5 1 13 13 13 13 13 13 13 1 5 11 0 0 0 0 4 4 4 4 4 5 4 0 4 4 11 0 0 0 14 4 4 0 0 4 0 0 
0 0 4 0 0 4 0 4 0 0 11 0 0 0 4 4 0 0 0 0 4 4 0 0 0 0 5 0 4 4 4 14 4 0 0 0 0 0 0 5 0 0 0 0 5 0 0 0 0 0 0 0 0 0 0 0 0 0 0 0 0 11 5 1 13 13 13 13 13 13 13 1 5 11 0 0 0 0 4 4 4 0 0 4 0 0 4 4 11 0 0 0 4 4 0 4 4 0 4 0
0 0 4 4 4 4 4 14 0 0 11 0 0 0 0 0 5 0 4 0 0 0 0 4 0 0 4 14 0 4 0 0 0 0 4 0 0 5 0 0 0 5 0 0 0 0 5 0 0 0 0 0 0 0 0 0 0 0 0 0 0 11 5 1 13 13 13 13 13 13 13 1 5 11 0 4 4 4 0 4 4 4 4 4 4 0 0 4 11 0 0 4 0 4 0 4 4 0 0 0
0 0 4 0 0 4 0 4 0 0 11 0 0 0 0 0 0 0 0 0 0 0 0 0 0 4 0 0 0 0 0 4 0 0 0 0 4 0 0 0 5 0 0 5 5 5 0 0 0 0 0 0 0 0 0 0 0 0 0 0 0 11 5 1 1 1 1 1 1 1 1 1 5 11 0 4 4 4 4 4 0 0 4 4 4 4 4 4 11 0 0 4 0 0 0 4 4 0 4 0
0 4 4 4 0 0 4 0 0 0 11 0 0 0 0 0 4 0 0 0 0 4 0 0 0 0 0 14 0 0 0 0 0 0 0 0 0 0 0 5 0 5 0 0 5 5 5 5 0 0 0 0 0 0 4 0 0 0 0 0 0 11 5 5 5 5 5 5 5 5 5 5 5 11 0 0 0 0 0 0 0 0 4 4 4 0 4 0 11 0 0 0 0 4 4 4 4 0 4 0
0 4 4 4 0 4 4 0 0 0 11 0 0 0 0 0 0 0 0 0 0 0 0 0 4 0 4 0 0 0 0 0 0 0 0 0 0 5 5 5 0 0 0 0 0 5 0 0 0 0 0 4 0 0 0 0 0 0 0 0 0 11 11 11 11 11 11 11 11 11 11 11 11 11 11 11 11 11 11 11 11 0 0 4 0 0 0 0 11 0 0 0 0 4 4 4 0 4 0 0
0 0 4 0 0 4 4 0 0 0 11 0 4 0 0 0 0 0 0 0 0 0 0 0 0 0 0 0 4 14 0 0 0 0 0 0 5 0 0 0 0 5 0 0 0 5 0 5 5 0 0 0 0 0 0 0 0 0 0 0 0 0 0 0 0 0 0 0 0 0 0 0 0 11 14 14 14 14 14 14 11 0 4 4 4 0 4 0 11 0 0 0 0 0 4 4 4 4 0 0
0 4 4 14 14 4 0 0 0 0 11 0 0 0 0 0 0 14 0 0 0 0 0 0 0 0 0 0 0 0 0 0 0 0 0 0 5 0 5 5 0 0 0 0 0 0 5 0 0 0 0 0 0 0 0 0 0 0 0 0 0 0 0 0 0 0 0 0 14 0 0 0 0 11 14 14 14 14 14 14 11 0 0 0 0 0 4 0 11 14 0 0 0 0 4 4 0 0 0 4
0 4 0 0 4 0 0 0 0 0 11 0 0 0 0 0 0 0 0 0 0 0 0 0 0 0 0 0 0 0 0 0 0 0 0 0 0 5 5 0 0 0 0 0 0 5 0 5 5 0 0 0 0 0 0 0 0 0 0 4 0 0 14 0 0 0 0 0 0 0 0 0 0 11 14 14 14 14 14 14 11 0 0 0 0 0 0 0 11 0 0 0 0 0 4 0 4 0 0 4
0 4 4 0 0 4 0 0 0 0 11 0 0 0 0 0 0 0 0 0 4 0 0 0 0 0 0 0 0 0 4 0 0 0 0 5 5 0 0 5 0 4 0 0 0 0 5 5 0 0 0 0 0 0 0 0 0 0 0 0 0 0 0 0 0 0 0 0 0 0 0 0 0 11 14 14 14 14 14 14 11 0 4 4 0 0 0 0 11 0 0 0 0 4 4 4 4 0 0 0
0 4 0 4 0 4 0 0 0 0 11 0 0 14 0 0 0 0 0 0 0 0 0 0 14 0 0 0 0 0 0 0 0 0 0 0 5 0 5 0 0 0 0 0 0 5 5 0 0 0 0 0 0 0 0 0 0 0 14 0 0 0 0 0 0 0 0 0 0 0 0 0 0 11 14 14 14 14 14 14 11 0 4 0 0 0 0 0 11 0 0 0 0 4 4 0 4 0 0 0
0 4 4 0 0 4 4 0 0 0 11 0 0 0 0 0 0 0 0 0 0 0 0 0 0 0 0 0 0 0 0 0 0 0 5 5 0 0 0 0 0 0 0 0 0 0 5 5 0 5 0 0 0 0 0 0 0 0 0 0 0 0 0 0 0 0 0 0 0 0 0 0 0 11 14 14 14 14 14 14 11 0 4 5 5 4 0 0 11 0 0 0 0 4 0 4 4 0 0 0
4 4 4 0 4 4 4 0 0 0 11 0 0 0 0 4 0 0 0 0 4 0 0 0 4 0 0 0 0 0 0 0 0 0 0 0 5 0 5 0 0 0 4 0 0 0 0 5 0 0 5 0 0 0 0 0 0 0 0 0 4 0 0 0 0 0 0 14 0 0 0 0 0 1 14 14 14 14 14 14 11 0 4 5 4 0 0 0 11 0 0 0 0 4 4 4 4 4 0 0 
4 4 0 0 4 4 0 4 0 0 11 0 14 0 0 0 0 0 0 0 0 0 0 0 0 0 0 0 4 0 0 0 0 0 0 0 5 5 0 5 0 0 0 0 0 0 0 0 0 5 5 5 5 0 0 0 0 0 0 0 0 0 0 0 0 0 0 0 0 0 0 0 0 5 14 14 14 14 14 14 11 0 0 4 4 0 0 0 11 0 0 0 0 4 0 4 4 4 0 0 
4 4 0 4 4 4 0 4 0 0 11 0 0 0 0 0 0 0 0 0 0 0 0 0 0 0 0 0 0 0 0 0 0 0 0 5 0 0 5 0 0 0 0 0 0 0 0 0 0 5 5 5 5 5 4 4 4 4 4 4 4 4 4 4 4 4 4 4 4 0 0 0 0 1 14 14 14 14 14 14 11 0 0 0 0 0 0 0 11 0 0 0 4 4 4 0 0 0 0 0 
4 4 0 4 4 14 0 0 0 0 11 0 0 0 0 0 0 0 0 0 0 0 0 14 0 14 0 0 0 0 0 0 0 0 0 5 5 0 0 5 0 0 0 0 4 0 0 0 0 0 0 0 5 5 5 5 5 5 5 5 5 5 5 5 5 5 5 5 4 4 4 4 4 4 4 4 4 4 14 4 11 0 4 0 0 5 0 0 11 0 0 0 4 4 0 4 0 4 0 0 
0 4 4 4 4 14 0 0 0 0 11 0 0 0 0 0 0 0 0 0 0 4 0 0 0 0 0 0 0 0 0 4 0 0 0 5 0 0 5 5 14 0 0 0 0 0 0 0 0 0 0 0 0 4 4 4 4 4 4 4 4 4 4 5 4 4 4 5 5 5 5 5 5 5 5 5 14 4 14 4 4 0 4 0 4 4 5 0 11 0 0 4 0 0 4 0 4 0 0 0
4 4 4 4 4 4 0 4 0 0 11 0 4 0 0 0 0 0 0 0 0 0 0 0 0 0 0 4 0 14 0 0 0 4 14 0 0 14 0 0 0 0 0 0 0 0 0 0 0 0 0 0 0 4 5 5 5 5 5 5 5 5 5 5 5 4 5 5 4 5 4 5 4 4 4 4 4 2 14 14 4 4 0 4 0 0 0 0 11 0 0 4 0 4 4 4 4 0 4 0 
4 4 0 4 4 0 0 4 0 0 11 0 0 0 0 0 0 4 0 0 0 0 0 14 14 14 4 0 14 14 14 0 14 0 14 0 0 0 0 0 14 0 0 0 0 0 0 0 0 0 0 0 0 4 5 4 5 5 4 4 4 5 4 4 5 4 5 4 4 5 4 4 4 5 5 14 2 14 2 14 4 4 4 4 0 0 5 0 11 0 0 0 0 0 0 4 4 0 0 0 
0 0 0 0 0 4 0 0 0 0 11 0 0 0 0 0 0 0 14 0 14 0 0 0 14 14 3 3 3 3 3 3 3 3 3 3 3 3 3 3 3 0 0 0 14 14 14 14 0 0 0 0 0 4 5 4 5 5 4 5 4 5 4 5 5 4 14 14 14 14 14 14 14 5 4 14 2 14 2 14 4 0 4 0 0 4 0 0 11 0 0 14 0 0 4 4 0 0 4 0
4 4 0 4 4 4 4 0 0 0 11 0 0 0 0 0 4 0 0 4 0 3 3 3 3 3 3 2 2 2 2 2 15 2 2 2 2 2 2 2 3 3 3 3 0 0 14 14 14 0 0 0 4 4 5 4 4 4 4 5 4 5 4 5 5 4 14 2 2 2 2 2 14 4 4 14 2 2 2 14 4 0 0 4 0 4 4 0 11 0 0 14 0 0 0 0 0 0 0 0 
4 4 0 4 4 4 4 14 0 0 11 0 0 0 0 0 0 0 0 0 3 3 2 2 2 2 2 2 2 2 2 15 15 2 2 2 2 2 2 2 2 2 2 3 3 3 3 0 0 0 0 0 4 14 14 5 5 5 5 5 4 5 4 4 5 4 14 14 14 2 14 14 14 4 5 14 2 14 2 14 4 0 0 4 0 5 0 0 11 0 0 0 0 4 0 4 0 0 4 0 
0 4 0 0 0 0 0 14 0 0 11 0 0 0 0 4 14 0 3 3 3 2 2 2 2 2 2 2 2 2 2 15 2 2 2 2 2 2 2 2 2 2 2 2 2 2 3 3 3 14 0 0 4 2 4 4 4 4 4 4 4 5 5 4 5 5 5 4 14 2 14 4 4 4 4 14 4 14 14 14 4 0 4 0 4 0 5 0 11 0 4 0 4 4 4 4 0 4 4 0
4 4 4 4 4 0 4 0 0 0 11 0 4 0 0 0 0 3 3 2 2 2 2 2 2 2 2 2 2 15 15 15 15 2 2 2 2 2 2 2 2 2 2 2 2 2 2 2 3 0 0 0 14 2 14 5 5 5 5 5 4 4 5 4 5 4 4 4 4 2 4 4 5 5 4 5 4 5 4 4 4 0 0 0 4 4 5 0 11 0 4 0 4 4 0 4 0 4 4 4 
4 4 4 4 4 0 4 0 0 0 11 0 0 0 14 0 3 3 2 2 2 2 2 2 2 2 2 15 15 15 2 2 15 15 15 2 2 2 2 2 2 2 2 2 2 2 2 2 3 3 0 0 14 2 14 4 4 4 4 5 5 4 5 5 5 4 5 5 14 14 14 14 14 14 4 5 4 5 5 5 4 0 4 4 0 0 4 0 11 0 4 0 0 4 0 4 0 4 4 0 
4 4 0 4 4 0 4 0 0 0 11 0 14 0 0 0 3 2 2 2 2 2 2 2 2 2 2 15 2 2 2 2 2 2 15 15 2 2 2 2 2 2 2 2 2 2 2 2 2 3 3 0 14 2 14 14 14 5 5 4 5 4 5 4 4 4 5 4 4 4 4 14 2 14 4 4 4 4 4 5 4 0 4 4 0 0 4 0 11 0 4 0 4 4 0 4 0 0 4 0 
4 0 4 0 4 4 4 0 0 0 11 0 4 4 0 3 3 2 2 2 2 2 2 2 2 2 2 15 2 2 2 2 2 2 2 15 2 2 2 2 2 2 2 2 2 2 2 2 2 2 3 0 14 2 2 2 4 4 5 4 5 4 5 4 5 5 5 4 5 5 4 14 2 14 4 5 5 5 4 5 4 0 0 4 5 14 14 0 11 0 4 4 4 4 0 4 0 0 4 4 
0 4 4 4 4 4 0 0 0 0 11 0 0 0 14 3 2 2 2 2 2 2 2 2 2 2 2 15 15 2 2 2 2 2 2 15 15 2 2 2 2 2 2 2 2 2 2 2 2 2 3 0 14 14 14 14 14 4 5 4 5 5 5 4 5 5 4 4 5 4 4 14 2 14 4 5 4 5 4 5 4 0 0 4 5 14 2 14 11 0 4 0 0 4 0 0 0 4 4 0
0 0 0 4 4 4 4 0 0 0 11 0 14 0 0 3 2 2 2 2 2 2 2 2 2 2 2 2 15 2 2 2 2 2 2 2 15 15 2 2 2 2 2 2 2 2 2 2 2 2 3 14 0 0 0 0 0 4 5 4 4 4 4 4 5 4 4 14 14 14 4 14 2 14 4 4 4 5 4 5 4 0 0 0 4 4 4 14 11 0 0 4 0 0 0 0 0 4 4 0
0 0 4 0 4 4 4 0 0 0 11 0 14 0 3 3 2 2 2 2 2 2 2 2 2 2 2 15 15 15 2 2 2 2 2 2 2 15 2 2 2 2 2 2 2 2 2 2 2 3 3 0 4 0 0 4 4 4 5 5 5 5 5 5 5 4 5 14 2 14 14 14 2 14 5 5 5 5 4 5 4 0 4 0 4 4 14 14 11 0 0 4 0 0 0 0 0 0 4 4
0 0 0 4 4 14 4 0 0 0 11 4 0 3 3 2 2 2 2 2 2 2 2 2 2 2 15 15 15 15 2 2 2 2 2 2 15 15 2 2 2 2 2 2 2 2 2 2 2 3 0 14 0 0 0 0 0 4 4 4 4 4 4 4 4 4 4 14 14 2 2 2 4 4 4 4 4 4 4 5 4 4 4 0 0 0 4 0 11 0 0 0 4 0 0 4 0 4 4 4
0 4 4 4 0 4 0 0 0 0 11 0 0 3 3 2 2 2 2 2 2 2 2 2 2 2 15 2 2 15 2 2 2 2 2 2 15 2 2 2 2 2 2 2 2 2 2 2 2 3 0 0 0 4 4 0 0 0 0 0 0 0 0 0 0 0 4 4 14 14 14 14 14 5 5 5 5 5 5 5 4 4 4 0 0 0 4 0 11 0 0 4 0 4 0 0 0 4 4 4
4 14 0 0 0 0 0 0 0 0 11 0 14 3 3 2 2 2 2 2 2 2 2 2 15 15 15 2 2 15 2 2 2 2 2 2 15 15 2 2 2 2 2 2 2 2 2 2 2 3 14 14 4 0 0 0 4 0 0 4 0 0 4 0 4 0 0 4 4 4 4 4 4 4 4 4 4 4 4 4 4 0 0 14 14 5 4 0 11 0 0 4 4 4 0 0 0 4 4 4
4 0 4 4 4 0 0 0 0 0 11 4 0 0 3 2 2 2 2 2 2 2 2 15 15 2 2 2 2 15 15 2 2 2 2 2 2 15 2 2 2 2 2 2 2 2 2 2 3 3 14 0 4 5 5 0 0 0 0 0 4 0 0 0 0 4 0 0 0 0 4 0 0 4 4 4 4 4 0 0 4 0 4 14 14 14 0 0 11 0 4 0 4 14 4 0 0 0 4 4 
0 0 4 4 4 4 0 0 0 0 11 0 0 0 3 2 2 2 2 2 2 2 2 15 2 2 2 2 2 3 3 3 2 2 2 2 2 15 2 2 2 2 2 2 2 2 2 2 3 3 14 0 0 5 0 0 4 0 0 0 0 4 0 0 4 0 0 4 0 0 4 0 0 4 4 4 4 4 0 4 4 4 4 4 4 14 14 0 11 0 0 0 4 4 0 0 0 0 4 0
0 0 4 4 4 0 0 0 0 0 11 0 14 14 3 3 2 2 2 2 2 2 2 15 15 2 2 2 3 3 3 3 3 2 2 2 2 15 2 2 2 2 2 2 2 2 2 3 3 14 0 4 4 0 0 0 0 0 0 4 0 0 0 0 4 0 0 0 0 0 14 14 4 0 0 4 4 4 4 4 4 4 4 2 4 4 4 0 11 0 4 0 4 0 0 0 4 4 4 0
0 0 4 4 0 0 4 4 0 0 11 0 4 14 14 3 2 2 2 2 2 2 2 2 15 2 2 2 3 3 3 3 3 2 2 2 15 15 2 2 2 2 2 2 2 2 3 3 14 0 0 0 0 0 0 0 0 0 4 4 0 0 0 0 0 0 0 0 14 4 4 14 4 4 4 4 4 4 0 4 4 4 2 2 2 4 4 0 11 0 4 0 4 4 4 0 4 4 4 0
0 0 4 4 0 0 4 0 0 0 11 0 0 4 14 3 2 2 2 2 2 2 2 2 15 15 2 2 3 3 3 3 3 2 2 2 15 2 2 2 2 2 2 2 2 3 3 0 14 4 0 0 0 0 5 4 0 5 0 0 0 4 0 0 5 0 4 14 14 2 14 14 4 4 0 4 0 4 4 4 14 2 2 2 2 4 4 0 11 0 4 0 0 4 4 0 4 4 4 0
0 4 4 0 0 0 4 0 0 0 11 0 0 0 14 3 3 2 2 2 2 2 2 2 2 15 15 2 2 3 3 3 2 2 2 15 15 2 2 2 2 2 2 2 3 3 0 14 4 0 4 0 0 0 0 0 0 0 0 4 14 14 14 14 14 14 0 14 2 2 2 4 0 4 5 0 0 4 4 4 4 4 14 4 4 14 4 0 11 0 0 0 4 4 4 0 0 0 0 0
4 4 4 4 0 4 4 4 0 0 11 0 0 0 0 3 3 2 2 2 2 2 2 2 2 2 15 15 2 2 2 2 2 2 15 15 15 2 2 2 2 2 3 3 3 14 14 0 0 0 0 0 0 4 0 5 4 0 0 0 14 14 2 14 2 14 4 4 14 2 14 4 0 0 0 4 4 4 0 4 4 4 14 14 14 14 4 0 11 0 4 0 4 4 4 0 4 4 0 0 
4 4 4 4 0 0 4 4 0 0 11 14 0 0 4 14 3 3 2 2 2 2 2 2 2 2 2 15 15 15 15 15 15 15 15 2 2 2 2 2 3 3 3 0 0 14 4 5 5 0 0 5 0 4 0 0 0 0 0 4 14 2 14 14 14 4 0 0 14 14 4 0 4 4 4 4 4 4 4 4 4 4 4 4 14 0 4 0 11 0 4 4 0 0 4 4 0 4 0 0 
4 0 0 0 0 4 4 0 0 0 11 0 0 4 0 14 14 3 3 2 2 2 2 2 2 2 2 2 2 2 2 2 2 2 2 2 2 2 2 3 3 0 14 0 0 0 0 4 0 4 0 0 0 0 0 0 0 0 14 14 4 14 2 14 5 0 0 4 0 0 4 4 0 4 4 4 4 4 4 4 4 4 4 4 0 4 4 0 11 0 0 4 4 0 0 4 4 0 0 0 
4 0 0 0 14 4 4 0 0 0 11 0 0 0 0 0 0 0 3 3 3 3 2 2 2 2 2 2 2 2 2 2 2 3 3 3 3 3 3 0 14 14 14 0 4 0 0 0 0 0 0 0 0 0 4 0 0 0 0 14 14 14 4 14 14 14 0 4 4 4 4 0 4 0 0 0 4 0 4 4 4 4 4 0 0 0 0 0 11 0 4 0 4 0 4 4 4 0 0 0 
4 0 0 0 4 0 4 0 0 0 11 11 11 11 11 11 11 11 11 11 11 11 11 11 11 11 11 11 11 11 11 11 11 11 11 11 11 11 11 11 11 11 11 11 11 11 11 11 11 11 11 11 11 11 11 11 11 11 11 11 11 11 11 11 11 11 11 11 11 11 11 11 11 11 11 11 11 11 11 11 11 11 11 11 11 11 11 11 11 0 4 4 4 0 4 4 4 0 0 0 
0 4 0 4 0 4 4 0 0 0 0 0 0 0 0 0 0 0 0 0 0 0 0 0 0 0 0 0 14 0 0 0 0 0 0 0 0 0 0 0 0 0 0 0 0 0 0 0 0 0 0 0 0 0 0 0 0 0 0 0 0 0 0 0 0 0 0 0 0 0 0 0 0 0 0 0 0 0 0 0 0 0 0 0 0 0 0 0 0 14 0 0 4 4 4 4 4 0 0 0
0 4 0 4 0 4 4 0 0 0 0 0 0 0 0 0 14 14 14 0 0 14 14 0 0 0 0 0 0 0 0 0 0 14 14 0 0 14 14 0 0 0 0 0 0 0 0 0 0 0 14 0 0 0 0 0 0 0 0 0 0 0 0 0 0 0 0 0 0 4 0 4 0 4 4 4 4 4 0 0 0 0 0 0 4 4 4 4 4 4 4 4 4 0 4 4 4 0 0 0
0 0 4 0 0 4 4 0 0 0 0 0 0 0 0 14 14 0 0 14 14 0 0 14 14 0 14 14 4 0 4 14 4 0 0 0 4 0 4 4 0 0 4 4 4 4 4 4 4 4 0 4 4 4 4 4 4 4 0 4 4 4 4 0 0 4 4 4 4 4 4 0 0 0 0 14 0 4 4 0 0 0 0 0 4 0 0 0 0 0 4 0 4 4 4 4 4 0 0 0
0 0 0 0 0 4 4 0 0 0 4 4 4 0 0 0 0 0 0 0 0 0 4 4 4 0 0 14 14 0 14 14 0 0 0 14 0 0 0 0 4 4 4 4 4 4 4 4 0 4 4 4 4 4 0 4 4 0 4 4 4 4 4 4 4 0 4 4 4 4 4 4 0 0 4 4 4 4 4 4 4 4 4 4 4 4 4 4 4 4 4 4 4 4 4 4 4 4 0 0
0 0 0 0 0 4 4 0 0 0 4 0 4 0 4 0 4 0 4 0 4 0 4 0 0 4 4 4 4 4 4 4 4 4 4 4 4 4 4 4 4 4 4 4 4 4 4 4 4 4 0 4 4 0 4 0 4 0 4 0 0 4 4 4 4 4 4 4 4 4 4 4 4 4 4 4 4 4 4 4 14 0 0 4 0 4 4 0 0 0 4 4 4 4 4 4 4 4 0 0
0 4 4 0 4 0 0 4 4 4 4 4 4 0 4 4 0 0 0 0 4 0 4 4 4 4 0 0 4 4 14 0 0 4 4 0 4 4 4 4 4 0 4 4 4 4 0 4 4 4 0 4 4 4 0 0 0 0 0 0 0 14 0 4 4 4 0 0 0 0 4 4 4 4 0 0 0 0 4 4 0 0 0 4 4 0 4 0 4 4 4 0 4 4 4 4 0 0 0 0
0 4 4 4 4 4 4 4 4 4 4 4 4 0 4 0 4 4 0 4 4 0 4 0 4 0 0 0 4 0 4 4 0 0 4 4 0 4 4 4 0 4 4 4 4 0 0 0 0 4 4 0 0 4 4 0 0 0 14 0 0 14 4 4 0 0 0 0 0 0 4 4 4 4 4 0 0 4 4 4 0 0 0 4 4 0 4 4 0 0 4 0 4 4 4 0 0 0 0 0
0 0 0 4 4 4 4 4 0 0 4 4 0 0 0 0 0 4 4 4 4 4 4 4 4 4 0 4 4 4 4 4 4 4 4 4 0 0 4 0 4 4 4 0 0 14 0 4 4 4 4 0 4 4 0 4 4 4 4 4 4 4 4 4 0 0 0 0 0 4 4 0 4 0 4 4 4 4 4 0 0 0 4 4 0 0 4 0 0 0 4 4 4 4 0 0 0 0 0 0
0 0 0 0 0 0 4 0 0 0 4 0 0 0 0 0 0 0 0 0 0 0 0 0 0 0 0 0 0 4 4 4 4 4 4 4 4 4 4 0 0 4 4 4 4 0 4 4 0 0 0 0 0 0 0 0 0 0 0 4 0 0 4 4 4 4 4 4 4 0 4 4 4 4 4 4 4 4 0 0 0 0 4 4 4 4 4 4 0 0 0 0 4 4 0 0 0 0 0 0
